9,9,9,9,9,9,9,9,9,9,9,9,9,9,9,9,9,7,7,9
8,9,0,0,0,9,0,0,0,0,0,0,0,0,0,0,0,0,0,9
8,9,0,0,0,0,0,0,0,0,0,0,0,0,0,0,0,0,0,9
9,9,9,9,9,9,0,0,0,0,0,0,0,0,0,9,9,9,9,9
9,0,0,0,0,0,0,0,0,0,0,0,0,0,0,9,0,0,0,9
9,0,0,0,0,0,0,9,9,9,0,0,0,0,0,9,0,0,0,9
9,0,0,0,0,0,0,0,9,0,0,0,0,0,0,9,0,0,0,9
9,9,9,9,9,9,9,9,9,0,0,0,0,0,0,9,0,0,0,9
8,9,0,9,9,9,0,0,9,0,0,0,0,0,0,0,0,0,0,9
8,9,0,0,0,0,0,0,9,0,0,0,0,0,0,9,0,0,0,9
8,9,9,0,0,0,0,0,9,0,0,9,9,9,9,9,9,9,9,9
9,9,0,0,0,0,0,0,9,0,0,9,0,0,0,0,0,0,0,9
9,0,0,0,0,0,0,0,0,0,0,9,0,0,0,0,0,0,0,9
9,9,9,0,0,0,0,0,0,0,0,0,0,0,0,0,0,0,0,5
8,9,9,9,9,9,9,9,9,9,9,9,9,9,9,9,9,9,9,9
